PSX	KEYWORD1
PSXDATA	KEYWORD1

read	KEYWORD2
setupPins	KEYWORD2
config	KEYWORD2

PSXBTN_LEFT	LITERAL1
PSXBTN_DOWN	LITERAL1
PSXBTN_RIGHT	LITERAL1
PSXBTN_UP	LITERAL1
PSXBTN_START	LITERAL1
PSXBTN_SELECT	LITERAL1
PSXBTN_SQUARE	LITERAL1
PSXBTN_CROSS	LITERAL1
PSXBTN_CIRCLE	LITERAL1
PSXBTN_TRIANGLE	LITERAL1
PSXBTN_R1	LITERAL1
PSXBTN_L1	LITERAL1
PSXBTN_R2	LITERAL1
PSXBTN_L2	LITERAL1

PSXERROR_SUCCESS	LITERAL1
PSXERROR_NODATA	LITERAL1
PSXMODE_ANALOG	LITERAL1
PSXMODE_DIGITAL	LITERAL1